Arcade=Arc
Alley=Aly
Annex=Anx
Avenue=Av
Beltway=Btwy
Branch=Brch
Boulevard=Blvd
Bypass=Byp
Byway=Bwy
Causeway=Cwy
Center=Ctr
Circle=Cir
Crescent=Csc
Crossing=Crs
Common=Cmn
Connector=Conn
Cove=Cv
Course=Cse
Court=Ct
Cutoff=Cut
Diagonal=Dgl
Drive=Dr
Esplanade=Esp
Extension=Ext
Expressway=Expwy
Ferry=Fry
Fork=Fk
Gateway=Gwy
Grade=Gr
Green=Grn
Greenway=Gwy
Freeway=Fwy
Highway=Hwy
Junction=Jct
Lane=Ln
Loop=Lp
Motorway=Mwy
Oval=Ov
Parkway=Pky
Passage=Ps
Pass=Ps
Path=Pth
Pathway=Pwy
Place=Pl
Plaza=Plz
Pike=Pk
Promenade=Prom
Quay=Qy
Quad=Qd
Quadrangle=Qd
Quadrant=Qt
Road=Rd
Route=Rte
Row=Rw
Run=Rn
Skyway=Skwy
Spur=Spr
Station=Sta
Street=St
Stravenue=Stra
Terrace=Ter
Throughway=Twy
Thruway=Twy
Trafficway=Twy
Trace=Tr
Track=Tk
Turnpike=Tpke
Trail=Trl
Viaduct=Vdct
View=Vw

Approach=Apr
Bridge=Br
Ramp=Rmp
Tunnel=Tun

Saint=St.
Fort=Ft.

North=N
South=S
East=E
West=W
Northwest=NW
Northeast=NE
Southwest=SW
Southeast=SE